Sukhumi	CAPITAL_OF	 Abkhazia
Kabul	CAPITAL_OF	 Afghanistan
Episkopi Cantonment	CAPITAL_OF	 Akrotiri and Dhekelia
Tirana	CAPITAL_OF	 Albania
Algiers	CAPITAL_OF	 Algeria
Pago Pago	CAPITAL_OF	 American Samoa
Andorra la Vella	CAPITAL_OF	 Andorra
Luanda	CAPITAL_OF	 Angola
The Valley	CAPITAL_OF	 Anguilla
St. John's	CAPITAL_OF	 Antigua and Barbuda
Buenos Aires	CAPITAL_OF	 Argentina
Yerevan	CAPITAL_OF	 Armenia
Oranjestad	CAPITAL_OF	 Aruba
Georgetown	CAPITAL_OF	 Ascension Island
Canberra	CAPITAL_OF	 Australia
Vienna	CAPITAL_OF	 Austria
Baku	CAPITAL_OF	 Azerbaijan
Nassau	CAPITAL_OF	 Bahamas
Manama	CAPITAL_OF	 Bahrain
Dhaka	CAPITAL_OF	 Bangladesh
Bridgetown	CAPITAL_OF	 Barbados
Minsk	CAPITAL_OF	 Belarus
Brussels	CAPITAL_OF	 Belgium
Belmopan	CAPITAL_OF	 Belize
Porto-Novo (official)	CAPITAL_OF	 Benin
Cotonou (de facto)	CAPITAL_OF	 Benin
Hamilton	CAPITAL_OF	 Bermuda
Thimphu	CAPITAL_OF	 Bhutan
Sucre(constitutional)	CAPITAL_OF	 Bolivia
La Paz (administrative)	CAPITAL_OF	 Bolivia
Sarajevo	CAPITAL_OF	 Bosnia and Herzegovina
Gaborone	CAPITAL_OF	 Botswana
Bras’lia	CAPITAL_OF	 Brazil
Road Town	CAPITAL_OF	 British Virgin Islands
Bandar Seri Begawan	CAPITAL_OF	 Brunei [a]
Sofia	CAPITAL_OF	 Bulgaria
Ouagadougou	CAPITAL_OF	 Burkina Faso
Bujumbura	CAPITAL_OF	 Burundi
Phnom Penh	CAPITAL_OF	 Cambodia
YaoundŽ	CAPITAL_OF	 Cameroon
Ottawa	CAPITAL_OF	 Canada
Praia	CAPITAL_OF	 Cape Verde
George Town	CAPITAL_OF	 Cayman Islands
Bangui	CAPITAL_OF	 Central African Republic
N'Djamena	CAPITAL_OF	 Chad
Santiago	CAPITAL_OF	 Chile
Flying Fish Cove	CAPITAL_OF	 Christmas Island
West Island	CAPITAL_OF	 Cocos (Keeling) Islands
Bogot‡	CAPITAL_OF	 Colombia
Moroni	CAPITAL_OF	 Comoros
Avarua	CAPITAL_OF	 Cook Islands
San JosŽ	CAPITAL_OF	 Costa Rica
Yamoussoukro (official)	CAPITAL_OF	 C™te d'Ivoire
Abidjan (former capital; still has many government offices)	CAPITAL_OF	 C™te d'Ivoire
Zagreb	CAPITAL_OF	 Croatia
Havana	CAPITAL_OF	 Cuba
Willemstad	CAPITAL_OF	 Curaao
Nicosia	CAPITAL_OF	 Cyprus
Prague	CAPITAL_OF	 Czech Republic
Kinshasa	CAPITAL_OF	 Democratic Republic of the Congo
Copenhagen	CAPITAL_OF	 Denmark
Djibouti	CAPITAL_OF	 Djibouti
Roseau	CAPITAL_OF	 Dominica
Santo Domingo	CAPITAL_OF	 Dominican Republic
Dili	CAPITAL_OF	 East Timor (Timor-Leste)
Hanga Roa	CAPITAL_OF	 Easter Island
Quito	CAPITAL_OF	 Ecuador
Cairo	CAPITAL_OF	 Egypt
San Salvador	CAPITAL_OF	 El Salvador
Malabo	CAPITAL_OF	 Equatorial Guinea
Asmara	CAPITAL_OF	 Eritrea
Tallinn	CAPITAL_OF	 Estonia
Addis Ababa	CAPITAL_OF	 Ethiopia
Stanley	CAPITAL_OF	 Falkland Islands
T—rshavn	CAPITAL_OF	 Faroe Islands
Palikir	CAPITAL_OF	 Federated States of Micronesia
Suva	CAPITAL_OF	 Fiji
Helsinki	CAPITAL_OF	 Finland
Paris	CAPITAL_OF	 France
Cayenne	CAPITAL_OF	 French Guiana
Papeete	CAPITAL_OF	 French Polynesia
Libreville	CAPITAL_OF	 Gabon
Banjul	CAPITAL_OF	 Gambia
Tbilisi	CAPITAL_OF	 Georgia
Berlin	CAPITAL_OF	 Germany
Accra	CAPITAL_OF	 Ghana
Gibraltar	CAPITAL_OF	 Gibraltar
Athens	CAPITAL_OF	 Greece
Nuuk	CAPITAL_OF	 Greenland
St. George's	CAPITAL_OF	 Grenada
HagŒt–a	CAPITAL_OF	 Guam
Guatemala City	CAPITAL_OF	 Guatemala
St. Peter Port	CAPITAL_OF	 Guernsey
Conakry	CAPITAL_OF	 Guinea
Bissau	CAPITAL_OF	 Guinea-Bissau
Georgetown	CAPITAL_OF	 Guyana
Port-au-Prince	CAPITAL_OF	 Haiti
Tegucigalpa	CAPITAL_OF	 Honduras
Budapest	CAPITAL_OF	 Hungary
Reykjav’k	CAPITAL_OF	 Iceland
New Delhi	CAPITAL_OF	 India
Jakarta	CAPITAL_OF	 Indonesia
Tehran	CAPITAL_OF	 Iran
Baghdad	CAPITAL_OF	 Iraq
Dublin	CAPITAL_OF	 Ireland
Douglas	CAPITAL_OF	 Isle of Man
"Jerusalem (declared, de facto)[i]"	CAPITAL_OF	 Israel
Rome	CAPITAL_OF	 Italy
Kingston	CAPITAL_OF	 Jamaica
Tokyo	CAPITAL_OF	 Japan
St. Helier	CAPITAL_OF	 Jersey
Amman	CAPITAL_OF	 Jordan
Astana	CAPITAL_OF	 Kazakhstan
Nairobi	CAPITAL_OF	 Kenya
Tarawa	CAPITAL_OF	 Kiribati
Pristina	CAPITAL_OF	 Kosovo[j]
Kuwait City	CAPITAL_OF	 Kuwait
Bishkek	CAPITAL_OF	 Kyrgyzstan
Vientiane	CAPITAL_OF	 Laos
Riga	CAPITAL_OF	 Latvia
Beirut	CAPITAL_OF	 Lebanon
Maseru	CAPITAL_OF	 Lesotho
Monrovia	CAPITAL_OF	 Liberia
Tripoli	CAPITAL_OF	 Libya
Vaduz	CAPITAL_OF	 Liechtenstein
Vilnius	CAPITAL_OF	 Lithuania
Luxembourg	CAPITAL_OF	 Luxembourg
Skopje	CAPITAL_OF	 Macedonia
Antananarivo	CAPITAL_OF	 Madagascar
Lilongwe	CAPITAL_OF	 Malawi
Kuala Lumpur	CAPITAL_OF	 Malaysia (official)
MalŽ	CAPITAL_OF	 Maldives
Bamako	CAPITAL_OF	 Mali
Valletta	CAPITAL_OF	 Malta
Majuro	CAPITAL_OF	 Marshall Islands
Nouakchott	CAPITAL_OF	 Mauritania
Port Louis	CAPITAL_OF	 Mauritius
Mexico City [e]	CAPITAL_OF	 Mexico
Chisinau	CAPITAL_OF	 Moldova
Monaco	CAPITAL_OF	 Monaco
Ulan Bator	CAPITAL_OF	 Mongolia
Podgorica	CAPITAL_OF	 Montenegro
Plymouth [f] (official)	CAPITAL_OF	 Montserrat
Brades Estate (de facto)	CAPITAL_OF	 Montserrat
Rabat	CAPITAL_OF	 Morocco
Maputo	CAPITAL_OF	 Mozambique
Naypyidaw	CAPITAL_OF	 Myanmar
Stepanakert	CAPITAL_OF	 Nagorno-Karabakh Republic
Windhoek	CAPITAL_OF	 Namibia
Yaren (de facto)	CAPITAL_OF	 Nauru
Kathmandu	CAPITAL_OF	 Nepal
Amsterdam (official)	CAPITAL_OF	 Netherlands
The Hague (de facto)	CAPITAL_OF	 Netherlands
NoumŽa	CAPITAL_OF	 New Caledonia
Wellington	CAPITAL_OF	 New Zealand
Managua	CAPITAL_OF	 Nicaragua
Niamey	CAPITAL_OF	 Niger
Abuja	CAPITAL_OF	 Nigeria
Alofi	CAPITAL_OF	 Niue
Kingston	CAPITAL_OF	 Norfolk Island
Pyongyang	CAPITAL_OF	 North Korea
Nicosia	CAPITAL_OF	 Northern Cyprus
Belfast	CAPITAL_OF	 Northern Ireland
Saipan	CAPITAL_OF	 Northern Mariana Islands
Oslo	CAPITAL_OF	 Norway
Muscat	CAPITAL_OF	 Oman
Islamabad	CAPITAL_OF	 Pakistan
Melekeok	CAPITAL_OF	 Palau
Panama City	CAPITAL_OF	 Panama
Port Moresby	CAPITAL_OF	 Papua New Guinea
Asunci—n	CAPITAL_OF	 Paraguay
Beijing	CAPITAL_OF	 People's Republic of China
Lima	CAPITAL_OF	 Peru
Manila	CAPITAL_OF	 Philippines
Adamstown	CAPITAL_OF	 Pitcairn Islands
Warsaw	CAPITAL_OF	 Poland
Lisbon	CAPITAL_OF	 Portugal
San Juan	CAPITAL_OF	 Puerto Rico
Doha	CAPITAL_OF	 Qatar
Taipei	CAPITAL_OF	 Republic of China (Taiwan)
Brazzaville	CAPITAL_OF	 Republic of the Congo
Bucharest	CAPITAL_OF	 Romania
Moscow	CAPITAL_OF	 Russia
Kigali	CAPITAL_OF	 Rwanda
El Aaiœn (declared)	CAPITAL_OF	 Sahrawi Arab Democratic Republic
Gustavia	CAPITAL_OF	 Saint BarthŽlemy
Jamestown	CAPITAL_OF	 Saint Helena
Basseterre	CAPITAL_OF	 Saint Kitts and Nevis
Castries	CAPITAL_OF	 Saint Lucia
Marigot	CAPITAL_OF	 Saint Martin
St. Pierre	CAPITAL_OF	 Saint Pierre and Miquelon
Kingstown	CAPITAL_OF	 Saint Vincent and the Grenadines
Apia	CAPITAL_OF	 Samoa
San Marino	CAPITAL_OF	 San Marino
S‹o TomŽ	CAPITAL_OF	 S‹o TomŽ and Pr’ncipe
Riyadh	CAPITAL_OF	 Saudi Arabia
Edinburgh	CAPITAL_OF	 Scotland
Dakar	CAPITAL_OF	 Senegal
Belgrade	CAPITAL_OF	 Serbia
Victoria	CAPITAL_OF	 Seychelles
Freetown	CAPITAL_OF	 Sierra Leone
Singapore	CAPITAL_OF	 Singapore
Philipsburg	CAPITAL_OF	 Sint Maarten
Bratislava	CAPITAL_OF	 Slovakia
Ljubljana	CAPITAL_OF	 Slovenia
Honiara	CAPITAL_OF	 Solomon Islands
Mogadishu	CAPITAL_OF	 Somalia
Hargeisa	CAPITAL_OF	 Somaliland
Pretoria (executive)	CAPITAL_OF	 South Africa
Bloemfontein (judicial)	CAPITAL_OF	 South Africa
Cape Town (legislative)	CAPITAL_OF	 South Africa
Grytviken	CAPITAL_OF	 South Georgia and the South Sandwich Islands
Seoul	CAPITAL_OF	 South Korea
Tskhinvali	CAPITAL_OF	 South Ossetia
Juba	CAPITAL_OF	 South Sudan
Madrid	CAPITAL_OF	 Spain
Sri Jayawardenapura-Kotte [g] (legislative; largely de facto)	CAPITAL_OF	 Sri Lanka
Colombo (previous capital; has some government offices)	CAPITAL_OF	 Sri Lanka
Jerusalem (declared)[i]	CAPITAL_OF	 State of Palestine
Ramallah and Gaza (de facto)	CAPITAL_OF	 State of Palestine
Khartoum	CAPITAL_OF	 Sudan
Paramaribo	CAPITAL_OF	 Suriname
Mbabane (administrative)	CAPITAL_OF	 Swaziland
Lobamba (royal and legislative)	CAPITAL_OF	 Swaziland
Stockholm	CAPITAL_OF	 Sweden
Bern	CAPITAL_OF	 Switzerland
Damascus	CAPITAL_OF	 Syria
Dushanbe	CAPITAL_OF	 Tajikistan
Dodoma (official); mostly de facto	CAPITAL_OF	 Tanzania
Dar es Salaam (former; some government offices remaining)	CAPITAL_OF	 Tanzania
Bangkok	CAPITAL_OF	 Thailand
LomŽ	CAPITAL_OF	 Togo
Nuku_alofa	CAPITAL_OF	 Tonga
Tiraspol	CAPITAL_OF	 Transnistria
Port of Spain	CAPITAL_OF	 Trinidad and Tobago
Edinburgh of the Seven Seas	CAPITAL_OF	 Tristan da Cunha
Tunis	CAPITAL_OF	 Tunisia
Ankara	CAPITAL_OF	 Turkey
Ashgabat	CAPITAL_OF	 Turkmenistan
Cockburn Town	CAPITAL_OF	 Turks and Caicos Islands
Funafuti	CAPITAL_OF	 Tuvalu
Kampala	CAPITAL_OF	 Uganda
Kiev	CAPITAL_OF	 Ukraine
Abu Dhabi	CAPITAL_OF	 United Arab Emirates
London	CAPITAL_OF	 United Kingdom;  England
"Washington, D.C."	CAPITAL_OF	 United States
Charlotte Amalie	CAPITAL_OF	 United States Virgin Islands
Montevideo	CAPITAL_OF	 Uruguay
Tashkent	CAPITAL_OF	 Uzbekistan
Port Vila	CAPITAL_OF	 Vanuatu
Vatican City	CAPITAL_OF	 Vatican City
Caracas	CAPITAL_OF	 Venezuela
Hanoi	CAPITAL_OF	 Vietnam
Cardiff	CAPITAL_OF	 Wales
Mata-Utu	CAPITAL_OF	 Wallis and Futuna
Sana‡	CAPITAL_OF	 Yemen
Lusaka	CAPITAL_OF	 Zambia
Harare	CAPITAL_OF	 Zimbabwe
 Afghanistan	HAS_CURRENCY	Afghan afghani
 C™te d'Ivoire	HAS_NATIONAL_ANIMAL	African Elephant
 South Sudan	HAS_NATIONAL_ANIMAL	African Fish Eagle
 Zambia	HAS_NATIONAL_ANIMAL	African Fish Eagle
 Rwanda	HAS_NATIONAL_ANIMAL	African Leopard
 Albania	HAS_CURRENCY	Albanian lek
 Alderney	HAS_CURRENCY	Alderney pound
 Algeria	HAS_CURRENCY	Algerian dinar
 Sahrawi Republic	HAS_CURRENCY	Algerian dinar
 Bolivia	HAS_NATIONAL_ANIMAL	Alpaca
 Chile	HAS_NATIONAL_ANIMAL	Andean Condor
 Ecuador	HAS_NATIONAL_ANIMAL	Andean Condor
 Angola	HAS_CURRENCY	Angolan kwanza
 Saudi Arabia	HAS_NATIONAL_ANIMAL	Arabian horse
 Argentina	HAS_CURRENCY	Argentine peso
 Armenia	HAS_CURRENCY	Armenian dram
 Nagorno-Karabakh Republic	HAS_CURRENCY	Armenian dram
 Aruba	HAS_CURRENCY	Aruban florin
 Ascension Island	HAS_CURRENCY	Ascension pound
 Iran	HAS_NATIONAL_ANIMAL	Asiatic Cheetah
 Moldova	HAS_NATIONAL_ANIMAL	Aurochs
 Australia	HAS_CURRENCY	Australian dollar
 Cocos (Keeling) Islands	HAS_CURRENCY	Australian dollar
 Kiribati	HAS_CURRENCY	Australian dollar
 Nauru	HAS_CURRENCY	Australian dollar
 Tuvalu	HAS_CURRENCY	Australian dollar
 Azerbaijan	HAS_CURRENCY	Azerbaijani manat
" Bahamas, The"	HAS_CURRENCY	Bahamian dollar
 Bahrain	HAS_CURRENCY	Bahraini dinar
 Belize	HAS_NATIONAL_ANIMAL	Baird's Tapir
 United States	HAS_NATIONAL_ANIMAL	Bald Eagle
 Bangladesh	HAS_CURRENCY	Bangladeshi taka
 Malawi	HAS_NATIONAL_ANIMAL	Bar-tailed Trogon
 Barbados	HAS_CURRENCY	Barbadian dollar
 Libya	HAS_NATIONAL_ANIMAL	Barbary lion
 Morocco	HAS_NATIONAL_ANIMAL	Barbary lion
 Gibraltar	HAS_NATIONAL_ANIMAL	Barbary Macaque
 Portugal	HAS_NATIONAL_ANIMAL	Barcelos Cock
 Estonia	HAS_NATIONAL_ANIMAL	Barn Swallow
 Canada	HAS_NATIONAL_ANIMAL	Beaver
 Belarus	HAS_CURRENCY	Belarusian ruble
 Belize	HAS_CURRENCY	Belize dollar
 India	HAS_NATIONAL_ANIMAL	Bengal Tiger 
 Bermuda	HAS_CURRENCY	Bermudian dollar
 Bhutan	HAS_CURRENCY	Bhutanese ngultrum
 Poland	HAS_NATIONAL_ANIMAL	Bielik Eagle
 Austria	HAS_NATIONAL_ANIMAL	Black Eagle
 Germany	HAS_NATIONAL_ANIMAL	Black Eagle
 Lesotho	HAS_NATIONAL_ANIMAL	Black Rhinoceros
 Bahamas	HAS_NATIONAL_ANIMAL	Blue Marlin
 Malta	HAS_NATIONAL_ANIMAL	Blue Rock Thrush
 Bolivia	HAS_CURRENCY	Bolivian boliviano
 Bosnia and Herzegovina	HAS_CURRENCY	Bosnia and Herzegovina convertible mark
 Botswana	HAS_CURRENCY	Botswana pula
 Zimbabwe	HAS_CURRENCY	Botswana pula
 Brazil	HAS_CURRENCY	Brazilian real
 South Georgia and the South Sandwich Islands	HAS_CURRENCY	British pound
 Guernsey	HAS_CURRENCY	British pound
 Isle of Man	HAS_CURRENCY	British pound
 Jersey	HAS_CURRENCY	British pound
 United Kingdom	HAS_CURRENCY	British pound
 British Virgin Islands	HAS_CURRENCY	British Virgin Islands dollar
 Finland	HAS_NATIONAL_ANIMAL	Brown Bear
 Brunei	HAS_CURRENCY	Brunei dollar
 Singapore	HAS_CURRENCY	Brunei dollar
 Bulgaria	HAS_CURRENCY	Bulgarian lev
 Spain	HAS_NATIONAL_ANIMAL	Bull
 Burma	HAS_CURRENCY	Burmese kyat
 Burundi	HAS_CURRENCY	Burundian franc
 Cambodia	HAS_CURRENCY	Cambodian riel
 Eritrea	HAS_NATIONAL_ANIMAL	Camel
 Kuwait	HAS_NATIONAL_ANIMAL	Camel
 Canada	HAS_CURRENCY	Canadian dollar
 Guyana	HAS_NATIONAL_ANIMAL	Canje Pheasant
 Cape Verde	HAS_CURRENCY	Cape Verdean escudo
 Philippines	HAS_NATIONAL_ANIMAL	Carabao (national animal)
 Cayman Islands	HAS_CURRENCY	Cayman Islands dollar
 Cameroon	HAS_CURRENCY	Central African CFA franc
 Central African Republic	HAS_CURRENCY	Central African CFA franc
 Chad	HAS_CURRENCY	Central African CFA franc
" Congo, Republic of the"	HAS_CURRENCY	Central African CFA franc
 Equatorial Guinea	HAS_CURRENCY	Central African CFA franc
 Gabon	HAS_CURRENCY	Central African CFA franc
 French Polynesia	HAS_CURRENCY	CFP franc
 New Caledonia	HAS_CURRENCY	CFP franc
 Wallis and Futuna	HAS_CURRENCY	CFP franc
 Kenya	HAS_NATIONAL_ANIMAL	Cheetah
 Chile	HAS_CURRENCY	Chilean peso
 People's Republic of China	HAS_NATIONAL_ANIMAL	Chinese Dragon
" China, People's Republic of"	HAS_CURRENCY	Chinese yuan
 North Korea	HAS_NATIONAL_ANIMAL	Chollima
 Costa Rica	HAS_NATIONAL_ANIMAL	Clay-colored Thrush
 Colombia	HAS_CURRENCY	Colombian peso
 Comoros	HAS_CURRENCY	Comorian franc
 Colombia	HAS_NATIONAL_ANIMAL	Condor
" Congo, Democratic Republic of the"	HAS_CURRENCY	Congolese franc
 Puerto Rico	HAS_NATIONAL_ANIMAL	Coqu’
 Costa Rica	HAS_CURRENCY	Costa Rican col—n
 Argentina	HAS_NATIONAL_ANIMAL	Cougar
 Nepal	HAS_NATIONAL_ANIMAL	Cow
 Croatia	HAS_CURRENCY	Croatian kuna
 Timor-Leste	HAS_NATIONAL_ANIMAL	Crocodile
 Cuba	HAS_CURRENCY	Cuban convertible peso
 Cyprus	HAS_NATIONAL_ANIMAL	Cypriot Mouflon
 Czech Republic	HAS_CURRENCY	Czech koruna
 Croatia	HAS_NATIONAL_ANIMAL	Dalmatian
 Denmark	HAS_CURRENCY	Danish krone
 Faroe Islands	HAS_CURRENCY	Danish krone
 Djibouti	HAS_CURRENCY	Djiboutian franc
 Jamaica	HAS_NATIONAL_ANIMAL	Doctor-Bird (national bird)
 Mauritius	HAS_NATIONAL_ANIMAL	Dodo
 Greece	HAS_NATIONAL_ANIMAL	Dolphin
 Dominican Republic	HAS_CURRENCY	Dominican peso
 Ethiopia	HAS_NATIONAL_ANIMAL	Donkey
Aremenia	HAS_NATIONAL_ANIMAL	Dragon
 Bhutan	HAS_NATIONAL_ANIMAL	Druk
 Papua New Guinea	HAS_NATIONAL_ANIMAL	Dugong (national marine mammal)
 Armenia	HAS_NATIONAL_ANIMAL	Eagle
 Nigeria	HAS_NATIONAL_ANIMAL	Eagle
 Anguilla	HAS_CURRENCY	East Caribbean dollar
 Antigua and Barbuda	HAS_CURRENCY	East Caribbean dollar
 Dominica	HAS_CURRENCY	East Caribbean dollar
 Grenada	HAS_CURRENCY	East Caribbean dollar
 Montserrat	HAS_CURRENCY	East Caribbean dollar
 Saint Kitts and Nevis	HAS_CURRENCY	East Caribbean dollar
 Saint Lucia	HAS_CURRENCY	East Caribbean dollar
 Saint Vincent and the Grenadines	HAS_CURRENCY	East Caribbean dollar
 Egypt	HAS_CURRENCY	Egyptian pound
 Norway	HAS_NATIONAL_ANIMAL	"Elk (Called ""Moose"" in the Americas)"
Australia	HAS_NATIONAL_ANIMAL	Emu
 Eritrea	HAS_CURRENCY	Eritrean nakfa
 Ethiopia	HAS_CURRENCY	Ethiopian birr
 Akrotiri and Dhekelia	HAS_CURRENCY	Euro
 Andorra	HAS_CURRENCY	Euro
 Austria	HAS_CURRENCY	Euro
 Belgium	HAS_CURRENCY	Euro
 Cyprus	HAS_CURRENCY	Euro
 Estonia	HAS_CURRENCY	Euro
 Finland	HAS_CURRENCY	Euro
 France	HAS_CURRENCY	Euro
 Germany	HAS_CURRENCY	Euro
 Greece	HAS_CURRENCY	Euro
 Ireland	HAS_CURRENCY	Euro
 Italy	HAS_CURRENCY	Euro
 Kosovo	HAS_CURRENCY	Euro
 Luxembourg	HAS_CURRENCY	Euro
 Malta	HAS_CURRENCY	Euro
 Monaco	HAS_CURRENCY	Euro
 Montenegro	HAS_CURRENCY	Euro
 Portugal	HAS_CURRENCY	Euro
 San Marino	HAS_CURRENCY	Euro
 Slovakia	HAS_CURRENCY	Euro
 Slovenia	HAS_CURRENCY	Euro
 Spain	HAS_CURRENCY	Euro
 Vatican City	HAS_CURRENCY	Euro
 Netherlands	HAS_CURRENCY	Euro
 Monaco	HAS_NATIONAL_ANIMAL	European Hedgehog
 Iceland	HAS_NATIONAL_ANIMAL	Falcon
 Falkland Islands	HAS_CURRENCY	Falkland Islands pound
 Antigua and Barbuda	HAS_NATIONAL_ANIMAL	Fallow Deer
 Faroe Islands	HAS_NATIONAL_ANIMAL	Faroes (sheep)
 Algeria	HAS_NATIONAL_ANIMAL	Fennec Fox
 Fiji	HAS_CURRENCY	Fijian dollar
Bahamas	HAS_NATIONAL_ANIMAL	Flamingo
 Taiwan	HAS_NATIONAL_ANIMAL	Formosan Black Bear
 Antigua and Barbuda	HAS_NATIONAL_ANIMAL	Frigate 
 France	HAS_NATIONAL_ANIMAL	Gallic Rooster
" Gambia, The"	HAS_CURRENCY	Gambian dalasi
 Bangladesh	HAS_NATIONAL_ANIMAL	Ganges River Dolphin
 Georgia	HAS_CURRENCY	Georgian lari
 Ghana	HAS_CURRENCY	Ghana cedi
 Gibraltar	HAS_CURRENCY	Gibraltar pound
 Tanzania	HAS_NATIONAL_ANIMAL	Giraffe
 Albania	HAS_NATIONAL_ANIMAL	Golden Eagle
 Mexico	HAS_NATIONAL_ANIMAL	Golden Eagle
 Nauru	HAS_NATIONAL_ANIMAL	Great Frigatebird
 Japan	HAS_NATIONAL_ANIMAL	Green Pheasant
 Grenada	HAS_NATIONAL_ANIMAL	Grenada Dove
 Uganda	HAS_NATIONAL_ANIMAL	Grey Crowned Crane
 Turkey	HAS_NATIONAL_ANIMAL	Grey Wolf
 Guatemala	HAS_CURRENCY	Guatemalan quetzal
 Guernsey	HAS_NATIONAL_ANIMAL	Guernsey cow
 Guinea	HAS_CURRENCY	Guinean franc
 Guyana	HAS_CURRENCY	Guyanese dollar
 Haiti	HAS_CURRENCY	Haitian gourde
 Panama	HAS_NATIONAL_ANIMAL	Harpy Eagle
 Antigua and Barbuda	HAS_NATIONAL_ANIMAL	Hawksbill turtle 
 Bangladesh	HAS_NATIONAL_ANIMAL	Hilsa
 Togo	HAS_NATIONAL_ANIMAL	Hippopotamus
 Haiti	HAS_NATIONAL_ANIMAL	Hispaniolan Trogon
 Honduras	HAS_CURRENCY	Honduran lempira
 Hong Kong	HAS_CURRENCY	Hong Kong dollar
 Argentina	HAS_NATIONAL_ANIMAL	Hornero
 Bermuda	HAS_NATIONAL_ANIMAL	Humpback Whale
 Hungary	HAS_CURRENCY	Hungarian forint
 Gambia	HAS_NATIONAL_ANIMAL	Hyena
 Iceland	HAS_CURRENCY	Icelandic kr—na
 Laos	HAS_NATIONAL_ANIMAL	Indian Elephant
 India	HAS_CURRENCY	Indian rupee
 Indonesia	HAS_CURRENCY	Indonesian rupiah
 Iran	HAS_CURRENCY	Iranian rial
 Iraq	HAS_CURRENCY	Iraqi dinar
 Ireland	HAS_NATIONAL_ANIMAL	Irish wolfhound
 Israel	HAS_NATIONAL_ANIMAL	Israeli Gazelle
 Israel	HAS_CURRENCY	Israeli new shekel
 Palestine	HAS_CURRENCY	Israeli new shekel
 Italy	HAS_NATIONAL_ANIMAL	Italian Wolf
 Jamaica	HAS_CURRENCY	Jamaican dollar
 Japan	HAS_CURRENCY	Japanese yen
 Jordan	HAS_CURRENCY	Jordanian dinar
 Sri Lanka	HAS_NATIONAL_ANIMAL	Jungle Fowl
 New Caledonia	HAS_NATIONAL_ANIMAL	Kagu
 Australia	HAS_NATIONAL_ANIMAL	Kangaroo
 Kazakhstan	HAS_CURRENCY	Kazakhstani tenge
 Kenya	HAS_CURRENCY	Kenyan shilling
 New Zealand	HAS_NATIONAL_ANIMAL	Kiwi
 Indonesia	HAS_NATIONAL_ANIMAL	Komodo Dragon
 Cambodia	HAS_NATIONAL_ANIMAL	Kouprey
 Kuwait	HAS_CURRENCY	Kuwaiti dinar
 Kyrgyzstan	HAS_CURRENCY	Kyrgyzstani som
 Laos	HAS_CURRENCY	Lao kip
 Latvia	HAS_CURRENCY	Latvian lats
 Lebanon	HAS_CURRENCY	Lebanese pound
 Somalia	HAS_NATIONAL_ANIMAL	Leopard
 Lesotho	HAS_CURRENCY	Lesotho loti
 Liberia	HAS_CURRENCY	Liberian dollar
 Libya	HAS_CURRENCY	Libyan dinar
 Belgium	HAS_NATIONAL_ANIMAL	Lion
 Bulgaria	HAS_NATIONAL_ANIMAL	Lion
 Liberia	HAS_NATIONAL_ANIMAL	Lion
 Luxembourg	HAS_NATIONAL_ANIMAL	Lion
 Netherlands	HAS_NATIONAL_ANIMAL	Lion
 Sweden	HAS_NATIONAL_ANIMAL	Lion
 United Kingdom	HAS_NATIONAL_ANIMAL	Lion
 Macedonia	HAS_NATIONAL_ANIMAL	Lion 
 Slovenia	HAS_NATIONAL_ANIMAL	Lipizzaner
 Lithuania	HAS_CURRENCY	Lithuanian litas
 Romania	HAS_NATIONAL_ANIMAL	Lynx
 Macau	HAS_CURRENCY	Macanese pataca
 Brazil	HAS_NATIONAL_ANIMAL	Macaw
" Macedonia, Republic of"	HAS_CURRENCY	Macedonian denar
 Angola	HAS_NATIONAL_ANIMAL	Magnificent Frigatebird
 Kiribati	HAS_NATIONAL_ANIMAL	Magnificent Frigatebird
 Madagascar	HAS_CURRENCY	Malagasy ariary
 Malawi	HAS_CURRENCY	Malawian kwacha
 Malaysia	HAS_NATIONAL_ANIMAL	Malayan Tiger 
 Malaysia	HAS_CURRENCY	Malaysian ringgit
 Maldives	HAS_CURRENCY	Maldivian rufiyaa
 Isle of Man	HAS_NATIONAL_ANIMAL	Manx
 Pakistan	HAS_NATIONAL_ANIMAL	Markhor
 Mauritania	HAS_CURRENCY	Mauritanian ouguiya
 Mauritius	HAS_CURRENCY	Mauritian rupee
 Singapore	HAS_NATIONAL_ANIMAL	Merlion
 Mexico	HAS_CURRENCY	Mexican peso
 Micronesia	HAS_CURRENCY	Micronesian dollar
 Moldova	HAS_CURRENCY	Moldovan leu
 Mongolia	HAS_CURRENCY	Mongolian tšgršg
 Argentina	HAS_NATIONAL_ANIMAL	Monk Parakeet
 Morocco	HAS_CURRENCY	Moroccan dirham
 Mozambique	HAS_CURRENCY	Mozambican metical
 Denmark	HAS_NATIONAL_ANIMAL	Mute Swan
 Namibia	HAS_CURRENCY	Namibian dollar
 Nepal	HAS_CURRENCY	Nepalese rupee
 Curaao	HAS_CURRENCY	Netherlands Antillean guilder
 Sint Maarten	HAS_CURRENCY	Netherlands Antillean guilder
 Taiwan (Republic of China)	HAS_CURRENCY	New Taiwan dollar
 Cook Islands	HAS_CURRENCY	New Zealand dollar
 New Zealand	HAS_CURRENCY	New Zealand dollar
 Niue	HAS_CURRENCY	New Zealand dollar
 Pitcairn Islands	HAS_CURRENCY	New Zealand dollar
 Nicaragua	HAS_CURRENCY	Nicaraguan c—rdoba
 Nigeria	HAS_CURRENCY	Nigerian naira
None	HAS_CURRENCY	None
None	HAS_CURRENCY	None
" Korea, North"	HAS_CURRENCY	North Korean won
 Norway	HAS_CURRENCY	Norwegian krone
 Democratic Republic of the Congo	HAS_NATIONAL_ANIMAL	Okapi
 Oman	HAS_CURRENCY	Omani rial
 Bangladesh	HAS_NATIONAL_ANIMAL	Oriental Magpie Robin 
 Jordan	HAS_NATIONAL_ANIMAL	Oryx
 Namibia	HAS_NATIONAL_ANIMAL	Oryx
 Qatar	HAS_NATIONAL_ANIMAL	Oryx
 Pakistan	HAS_CURRENCY	Pakistani rupee
 Palau	HAS_CURRENCY	Palauan dollar
 Palestinian territories	HAS_NATIONAL_ANIMAL	Palestine Sunbird
 Dominican Republic	HAS_NATIONAL_ANIMAL	Palmchat
 Paraguay	HAS_NATIONAL_ANIMAL	Pampas Fox
 Panama	HAS_CURRENCY	Panamanian balboa
 Papua New Guinea	HAS_CURRENCY	Papua New Guinean kina
 Paraguay	HAS_CURRENCY	Paraguayan guaran’
 United Arab Emirates	HAS_NATIONAL_ANIMAL	Peregrine Falcon
 Peru	HAS_CURRENCY	Peruvian nuevo sol
 Philippines	HAS_CURRENCY	Philippine peso
 Greenland	HAS_NATIONAL_ANIMAL	Polar Bear
 Poland	HAS_CURRENCY	Polish z_oty
 Qatar	HAS_CURRENCY	Qatari riyal
 Guatemala	HAS_NATIONAL_ANIMAL	Quetzal
 land Islands	HAS_NATIONAL_ANIMAL	Red Deer
 Madagascar	HAS_NATIONAL_ANIMAL	Ring Tailed Lemur
 Romania	HAS_CURRENCY	Romanian leu
 Bangladesh	HAS_NATIONAL_ANIMAL	Royal Bengal Tiger
 Uruguay	HAS_NATIONAL_ANIMAL	Rufous Hornero
 Russia	HAS_NATIONAL_ANIMAL	Russian Bear
 Russia	HAS_CURRENCY	Russian ruble
 South Ossetia	HAS_CURRENCY	Russian ruble
 Rwanda	HAS_CURRENCY	Rwandan franc
 Zimbabwe	HAS_NATIONAL_ANIMAL	Sable Antelope
 Saint Helena	HAS_CURRENCY	Saint Helena pound
 Tristan da Cunha	HAS_CURRENCY	Saint Helena pound
 El Salvador	HAS_CURRENCY	Salvadoran col—n
 Samoa	HAS_CURRENCY	Samoan t_l_
 S‹o TomŽ and Pr’ncipe	HAS_CURRENCY	S‹o TomŽ and Pr’ncipe dobra
 Saudi Arabia	HAS_CURRENCY	Saudi riyal
 Trinidad and Tobago	HAS_NATIONAL_ANIMAL	Scarlet Ibis
 Sudan	HAS_NATIONAL_ANIMAL	Secretarybird
 Serbia	HAS_CURRENCY	Serbian dinar
 Seychelles	HAS_CURRENCY	Seychellois rupee
 Sierra Leone	HAS_CURRENCY	Sierra Leonean leone
 Afghanistan	HAS_NATIONAL_ANIMAL	Snow Leopard
 Solomon Islands	HAS_CURRENCY	Solomon Islands dollar
 Somalia	HAS_CURRENCY	Somali shilling
 Somaliland	HAS_CURRENCY	Somaliland shilling
 South Africa	HAS_CURRENCY	South African rand
" Korea, South"	HAS_CURRENCY	South Korean won
 South Sudan	HAS_CURRENCY	South Sudanese pound
 South Africa	HAS_NATIONAL_ANIMAL	Springbok
 Sri Lanka	HAS_CURRENCY	Sri Lankan rupee
 Saint Vincent and the Grenadines	HAS_NATIONAL_ANIMAL	St Vincent Parrot
 Egypt	HAS_NATIONAL_ANIMAL	Steppe Eagle
 Seychelles	HAS_NATIONAL_ANIMAL	Striped Dolphin
 Lebanon	HAS_NATIONAL_ANIMAL	Striped Hyena
 Sudan	HAS_CURRENCY	Sudanese pound
 Suriname	HAS_CURRENCY	Surinamese dollar
 Swaziland	HAS_CURRENCY	Swazi lilangeni
 Sweden	HAS_CURRENCY	Swedish krona
 Liechtenstein	HAS_CURRENCY	Swiss franc
 Switzerland	HAS_CURRENCY	Swiss franc
 Syria	HAS_CURRENCY	Syrian pound
 Tajikistan	HAS_CURRENCY	Tajikistani somoni
 Tanzania	HAS_CURRENCY	Tanzanian shilling
 Thailand	HAS_CURRENCY	Thai baht
 Thailand	HAS_NATIONAL_ANIMAL	Thai Elephant
 Swaziland	HAS_NATIONAL_ANIMAL	Thomson's Gazelle
 Myanmar	HAS_NATIONAL_ANIMAL	Tiger
 South Korea	HAS_NATIONAL_ANIMAL	Tiger
 Vietnam	HAS_NATIONAL_ANIMAL	Tiger
 Cuba	HAS_NATIONAL_ANIMAL	Tocororo
 Tonga	HAS_CURRENCY	Tongan pa_anga
 Transnistria	HAS_CURRENCY	Transnistrian ruble
 Trinidad and Tobago	HAS_CURRENCY	Trinidad and Tobago dollar
 Tunisia	HAS_CURRENCY	Tunisian dinar
 Northern Cyprus	HAS_CURRENCY	Turkish lira
 Turkey	HAS_CURRENCY	Turkish lira
 Turkmenistan	HAS_CURRENCY	Turkmenistani manat
 Venezuela	HAS_NATIONAL_ANIMAL	Turpial
 El Salvador	HAS_NATIONAL_ANIMAL	Turquoise-browed Motmot
 Nicaragua	HAS_NATIONAL_ANIMAL	Turquoise-browed Motmot
 Hungary	HAS_NATIONAL_ANIMAL	Turul
 Uganda	HAS_CURRENCY	Ugandan shilling
 Ukraine	HAS_CURRENCY	Ukrainian hryvnia
 United Arab Emirates	HAS_CURRENCY	United Arab Emirates dirham
 Bonaire	HAS_CURRENCY	United States dollar
 British Indian Ocean Territory	HAS_CURRENCY	United States dollar
 East Timor	HAS_CURRENCY	United States dollar
 Ecuador	HAS_CURRENCY	United States dollar
 Marshall Islands	HAS_CURRENCY	United States dollar
 Saba	HAS_CURRENCY	United States dollar
 Sint Eustatius	HAS_CURRENCY	United States dollar
 Turks and Caicos Islands	HAS_CURRENCY	United States dollar
 United States	HAS_CURRENCY	United States dollar
 Uruguay	HAS_CURRENCY	Uruguayan peso
 Uzbekistan	HAS_CURRENCY	Uzbekistani som
 Vanuatu	HAS_CURRENCY	Vanuatu vatu
 Venezuela	HAS_CURRENCY	Venezuelan bol’var
 Saint Kitts and Nevis	HAS_NATIONAL_ANIMAL	Vervet Monkey
 Peru	HAS_NATIONAL_ANIMAL	Vicu–a
 Vietnam	HAS_CURRENCY	Vietnamese __ng
 Benin	HAS_CURRENCY	West African CFA franc
 Burkina Faso	HAS_CURRENCY	West African CFA franc
 C™te d'Ivoire	HAS_CURRENCY	West African CFA franc
 Guinea-Bissau	HAS_CURRENCY	West African CFA franc
 Mali	HAS_CURRENCY	West African CFA franc
 Niger	HAS_CURRENCY	West African CFA franc
 Senegal	HAS_CURRENCY	West African CFA franc
 Togo	HAS_CURRENCY	West African CFA franc
 Serbia	HAS_NATIONAL_ANIMAL	White Eagle
 Belarus	HAS_NATIONAL_ANIMAL	White Stork
 Lithuania	HAS_NATIONAL_ANIMAL	White Stork
 Latvia	HAS_NATIONAL_ANIMAL	White Wagtail
 Honduras	HAS_NATIONAL_ANIMAL	White-tailed Deer
 Belarus	HAS_NATIONAL_ANIMAL	Wisent
 Maldives	HAS_NATIONAL_ANIMAL	Yellow-fin Tuna
 Yemen	HAS_CURRENCY	Yemeni rial
 Zambia	HAS_CURRENCY	Zambian kwacha
 Botswana	HAS_NATIONAL_ANIMAL	Zebra
 Anguilla	HAS_NATIONAL_ANIMAL	Zenaida Dove
